(......)
(.#....)
(....%.)
(.#..#.)
(.#..%.)
(@...&.)
