(......)
(.#....)
(....%.)
(.#....)
(......)
(@...&.)
