(......)
(.#..#.)
(.#..%.)
(.#..#.)
(..%.%.)
(@...&.)
